D  O    W W  W
 WWWWWW W W  W
 WD         DW
 WWWWWWWW W  W
  E     WW   W
WWWWWWW      W
